NO           ./assets_xpm/pixel_winter64.xpm
SO  ./assets_xpm/pixel_summer64.xpm

F    7,5,    3
C 0    ,0 ,    0

EA       ./assets_xpm/pixel_spring64.xpm
WE  ./assets_xpm/pixel_autumn64.xpm

        1111111111111111111111111
        1000000000110000000000001
        1011000000000000011111111
        1001000000000000000000001                           1 11
111111111011000001110000000000001
100000000011000001110111110111110
11110111111111011100000010001  1
11110111111111011101010010001
11000000110101011100000010001  1
10000000000000001101010010001  1
11000001110101011111011110N01111
11110111 1110101 101111010001  1
11111111 1111111 111111111111  1
1
1