11111111111111111111
10000000000100000001
10000000000100000001
10000000000100000001
11100100100100000001
10000000000000111111
10000010101000111111
11110001010100000001
10010000000000000001
10011100000111111111
10010000000000000111
10010000000111111111
10000N00000000011111
10010000000000000001
10010000110000000001
10010000110000000001
10010000110000000001
11111111111111111111
