11111111111111111111
10000000000100000001
11111100000100000001
10000000000000111111
10000000000000000001
10010000000000001001
10010000000000001001
11111111111111111111
