111111111111111
100000000000001
101010101010001
10000000P111111
111000000000001
100000000000001
100001111000001
100001010000001
111111111111111
