111111111111111
100000000000001
101010201N10001
100000200111111
111000000000001
100000000000001
100001111000001
100001010000001
111111111111111
