NO  ./assets_xpm/pixel_winter64.xpm
SO  ./assets_xpm/pixel_summer64.xpm

F    7,5,    3
C 2,          50,235

EA       ./assets_xpm/pixel_spring64.xpm
WE  ./assets_xpm/pixel_autumn64.xpm

11111111
101S0001
10000111
10000001
11100001
10000001
10010001
11111111
