NO  ./assets_xpm/pixel_winter64.xpm
SO  ./assets_xpm/pixel_summer64.xpm

C  0,  0, 0
F  0,0 , 0

EA  ./assets_xpm/pixel_spring64.xpm
WE  ./assets_xpm/pixel_autumn64.xpm



        1111111111111111111111111
        1000000000000000000000001
101111111000000000000000000000001
10110000000000N001111111111111111
10010000000000000000000011
1111111111111111111111111
